Spider-man
An Interactive Fiction by Michael Trinidad
Release 1 / Serial number 170209 / Inform 7 build 6M62 (I6/v6.33 lib 6/12N) SD

You quietly land behind the Green Goblin without him knowing. The bank tellers and guests are all cowering behind cover as you see the Green Goblin floating on his hoverboard.

"Made it just in time. I should probably web him up before punching him or else he might dodge the punch."

>actions
Actions listing on.

>jump down
I only understood you as far as wanting to jump.

* * *

Spider-man
An Interactive Fiction by Michael Trinidad
Release 1 / Serial number 170209 / Inform 7 build 6M62 (I6/v6.33 lib 6/12N) SD

You quietly land behind the Green Goblin without him knowing. The bank tellers and guests are all cowering behind cover as you see the Green Goblin floating on his hoverboard.

"Made it just in time. I should probably web him up before punching him or else he might dodge the punch."

>jump down
Bank
You can see The Green Goblin here.

>jump
You jump on the spot.

>s
Bank
The bank tellers and guests are all cowering behind cover as you see the Green Goblin floating on his hoverboard. "Made it just in time. Now lets see, do we want to punch him then web him up? or web him up then punch him?"

>n
Building Roof
"My spidey senses are telling me that the Green Goblin is robbing a bank right across the street below. Luckily he doesn't know I'm here so lets jump down and say hi."

>jump south
I only understood you as far as wanting to jump.

>jump down
I only understood you as far as wanting to jump.

>down
Which do you mean, the south or the down?

>down
Which do you mean, the south or the down?

>actions
Actions listing on.

>jump
[jumping]
You jump on the spot.
[jumping - succeeded]

>jump down
I only understood you as far as wanting to jump.

* * *

>jump
You jump on the spot.

>jump south
Bank
The bank tellers and guests are all cowering behind cover as you see the Green Goblin floating on his hoverboard. "Made it just in time. Now lets see, do we want to punch him then web him up? or web him up then punch him?"

>jump up
You can't go that way.

>jump sout
You can't see any such thing.

>jump south
You can't go that way.

>jump down
Which do you mean, the south or the down?

>down
Which do you mean, the south or the down?

* * *

>jump down
Bank
You can see The Green Goblin here.

>south
Bank
The bank tellers and guests are all cowering behind cover as you see the Green Goblin floating on his hoverboard. "Made it just in time. Now lets see, do we want to punch him then web him up? or web him up then punch him?"

>n
Building Roof
"My spidey senses are telling me that the Green Goblin is robbing a bank right across the street below. Luckily he doesn't know I'm here so lets jump down and say hi."

>jump down
I only understood you as far as wanting to jump.

>down
You can't go that way.

>down
You can't go that way.

>jump down
I only understood you as far as wanting to jump.

>jump
You jump on the spot.

>down
You can't go that way.

>south
Bank
The bank tellers and guests are all cowering behind cover as you see the Green Goblin floating on his hoverboard. "Made it just in time. Now lets see, do we want to punch him then web him up? or web him up then punch him?"

* * *

>jump down
I only understood you as far as wanting to jump.

>lay down
That's not a verb I recognise.

>sit down
I didn't understand that sentence.

* * *

>jump down
Bank
You can see The Green Goblin here.

>punch him
The green goblin dodged your attack! Try webbing him up first!

>web him up
The Green Goblin is now tied up in high density webbing and can't move.

* * *

>punch him
The green goblin dodged your attack! Try webbing him up first!

>punch him
The green goblin dodged your attack! Try webbing him up first!

* * *

>web him up
The Green Goblin is now tied up in high density webbing and can't move.

>punch him
You punch the him right in his dome.

The green goblin falls on the ground, unconcious.

Awesome job! Cops shoud be here soon. We should get outa here before we get into more trouble.

    *** The End ***

Would you like to RESTART, RESTORE a saved game, QUIT or UNDO the last command?

>restart
Spider-man
An Interactive Fiction by Michael Trinidad
Release 1 / Serial number 170209 / Inform 7 build 6M62 (I6/v6.33 lib 6/12N) SD

You quietly land behind the Green Goblin without him knowing. The bank tellers and guests are all cowering behind cover as you see the Green Goblin floating on his hoverboard.

"Made it just in time. I should probably web him up before punching him or else he might dodge the punch."

>jump down
Bank
You can see The Green Goblin here.

>look
You quietly land behind the Green Goblin without him knowing. The bank tellers and guests are all cowering behind cover as you see the Green Goblin floating on his hoverboard.

"Made it just in time. I should probably web him up before punching him or else he might dodge the punch."

>look at green goblin
You see nothing special about The Green Goblin.

>examine green goblin
You see nothing special about The Green Goblin.

>see green goblin
That's not a verb I recognise.

>look room
You can't see any such thing.

>look at room
You can't see any such thing.

>see room
That's not a verb I recognise.

>loo kroom
That's not a verb I recognise.

>examine room
You can't see any such thing.

>look
You quietly land behind the Green Goblin without him knowing. The bank tellers and guests are all cowering behind cover as you see the Green Goblin floating on his hoverboard.

"Made it just in time. I should probably web him up before punching him or else he might dodge the punch."

* * *

>jump down
Bank
You can see The Green Goblin here.

>web him up
The Green Goblin is now tied up in high density webbing and can't move.

>web Green Goblin up
You can't see any such thing.

>web up
You can't see any such thing.

>webbing
(yourself)
The Green Goblin is now tied up in high density webbing and can't move.

* * *

>web Green Goblin up
You can't see any such thing.

>web Green Goblin
You can't see any such thing.

>web
(yourself)
The Green Goblin is now tied up in high density webbing and can't move.

* * *

>web him up
The Green Goblin is now tied up in high density webbing and can't move.

>web green goblin up
You can't see any such thing.

>web him up
I'm not sure what 'him' refers to.

* * *

>punch him
You punch the him right in his dome.

The green goblin falls on the ground, unconcious.

Awesome job! Cops shoud be here soon. We should get outa here before we get into more trouble.

    *** The End ***

Would you like to RESTART, RESTORE a saved game, QUIT or UNDO the last command?

>punch the green goblin
Violence isn't the answer to this one.

>punch
(the Green Goblin)
Violence isn't the answer to this one.

* * *

>jump down
Bank
You can see The Green Goblin here.

>punch
(the Green Goblin)
Violence isn't the answer to this one.

>punch Green Goblin
Violence isn't the answer to this one.

>examine Green Goblin
You see nothing special about the Green Goblin.

>green gobline
That's not a verb I recognise.

>web Green Goblin up
The Green Goblin is now tied up in high density webbing and can't move.

>punch green goblin
Violence isn't the answer to this one.

>punch Green Goblin
Violence isn't the answer to this one.

* * *

>jump down
Bank
You can see The Green Goblin here.

>north
Building Roof
"My spidey senses are telling me that the Green Goblin is robbing a bank right across the street below. Luckily he doesn't know I'm here so lets jump down and say hi."

>south
Bank
You quietly land behind the Green Goblin without him knowing. The bank tellers and guests are all cowering behind cover as you see the Green Goblin floating on his hoverboard.

"Made it just in time. I should probably web him up before punching him or else he might dodge the punch."

You can see The Green Goblin here.

>punch him
The green goblin dodged your attack! Try webbing him up first!

* * *

Spider-man
An Interactive Fiction by Michael Trinidad
Release 1 / Serial number 170209 / Inform 7 build 6M62 (I6/v6.33 lib 6/12N) SD

You quietly land behind the Green Goblin without him knowing. The bank tellers and guests are all cowering behind cover as you see the Green Goblin floating on his hoverboard.

"Made it just in time. I should probably web him up before punching him or else he might dodge the punch."

>jump
Bank
The bank tellers and guests are all cowering behind cover as you see the Green Goblin floating on his hoverboard. "Made it just in time. Now lets see, do we want to punch him then web him up? or web him up then punch him?"

>jump down
I only understood you as far as wanting to jump.

* * *

>jump
Bank
The bank tellers and guests are all cowering behind cover as you see the Green Goblin floating on his hoverboard. "Made it just in time. Now lets see, do we want to punch him then web him up? or web him up then punch him?"

>n
Building Roof
"My spidey senses are telling me that the Green Goblin is robbing a bank right across the street below. Luckily he doesn't know I'm here so lets jump down and say hi."

* * *

>jump down
I only understood you as far as wanting to jump.

>jumping down
That's not a verb I recognise.